


















