9
9
9
9
;;;;;;9
9;;;9999;;;;9
9;;999999999;;;9
9;999999999999;9
;999999999999;;;9
9;99999999999999;9
99;9999999999999;;9
9;999999999999;;9
;;;99999999999;99
9;;;99999999;;9
9;;;;;;;;;;99
99;;;999
99999
999


